11 11 10
...........
#...#..#...
#...#..#...
.......#...
...#..#..#.
.###..#..#.
...........
.#..#..#.#.
.#....#....
...#..#....
#.#........